########################################
#@********************%#   $#       # $#
#****#####$$# ####****      # ####  # $#
#****#####$$######**** #      ####  # $#
#********************* #   $#        %$#
##################################### $#
#b                             %   #  ##
#  ##########           ######     ## $#
#  #########  #######   ##*$*$     ## ##
#  ##**#$$##  #$$$$$$   ##*$*$     ## *#
#  ###******  #$##$##   ######     ## *#
#  #########% $$$$$##    %         ## *#
#             #######                 *#
############  ##########################
# #####   *       *        #####b      #
# ###  $$$$###########   #######   ##  #
#B   ##$$$$###########**      ##  ######
# ##****##    #######   ####**##  ###$ #
# ##**######    **     ######     $$$$ #
########################################
