########################################
###########***********%#  ####$$$$$$$$$#
#****     $$######****  % ####         #
#****#####$$######**** #       ###**####
##################################**####
###############################        #
#               ###    #B   B#        ##
#  ##      ##   ###    #######     ## $#
#  #########  #######     *$*$  #####$$#
#  ##**#$$##  #$$$$$$ ########     ##$*#
#       b                  ##   #####$*#
#  #########% $$$$$##    %  ##$$$$$##$*#
#             #######*****#####$$$$$$$*#
#    **********                        #
# #####   *       *        #####b      #
# ###  $$$$###########   #######   ##  #
#    ##$$$$###########**      ##  ######
# ##****##    #######  @####**##  ###$ #
# ##**######    **     ######     $$$$ #
########################################