###########################################################
#*#        #        ###     B#*   ###$$$$#    ##$$$$$#    #
#*#$##$##*#####   #     ######    *###b**#    ##   ### ## #
#*#$#$$#     ####$ ######    #      ###**###  ##*#     #  #
#*## ###  ######## ####      #      *###   #  ##########  #
#b                           #            b#           ## #
############################ #*######################b    #
###########################      ###################**#####
#####$$      #####  ##  ######    ################***###$$#
#$$####  ### #####   #  #$#                   ##***#####$##
#   ### ####            $@$                   ***#######$##
###$     ###  ###  ###  #$#################################
#######  ###  ########  #$#     # ##$$##*### ##       ##  #
#               ####    #$# ### # ##$$#*###    #######    #
#**####*###*####     ## #$#$# #   ###$##*               ###
#$$#****# #*#***     ## #$$$# #%#******#**###########$$$###
#$$#$##*# #*#$##% ##    #####   ####$#***############$$####
#$$####*###*####  ##    ##### #  #$$####b                 #
#*************** ####   *#### ####$$#$$### ###$# #$### ##$#
##############          **#    #*##$##%    #######     ##$#
#$$  ###    #### #######$#  ## #*#      #########     ##$$#
#$##    $##      ####      ###     ######*****       ####$#
###########################################################