###########################################################
#@********************%#   $#       #     #             # #
#****#####  ######****      # ####  #  #             #  # #
#****#####+ ######**** #      ####  #    ##         #$    #
#********************* #   $#           ####       #$$  # #
#####################################   ####      #$$$  # #
#b                                  ##################### #
#  ##########           ######      #                     #
#  #########  #######   ##*         # #  #                #
#  ##**#$$##  #         ##*         #  #**#      $#####   #
#  ###******  # ## ##   ######      #   #  #      #####   #
#  #########%      ##    %          #    #**#     #####   #
#             #######                  %  #  #      ++    #
####################################### ###**##############
# #####                    #####        ###     ##  ## ## #
# ###      ###########   #######   ##   ###  # ##     ### #
#    ##    ###########        ##  ##### ###  # #   ##     #
# ##    ##    #######   ####  ##  ###$  ###  #   ######## #
# ##  ######           ######     $$$$  ###  ##############
# #########################################  #  %$$$$$$$$$#
# B  ##    #   ###            ####       ##      $$$$$#####
#       ##   #     ##########       ####         *****$$$$#
###########################################################